WWWWWWWWWWWWWW
WNNNNNNNNNNNNW
WNNNNNNNNNNNNW
WNNNNNNNNNNNNW
ONNNNNNNNNNNNW
WNNNNNNNNNNNNW
WNNNNNNNNNNNNW
WNNNNNNNNNNNNW
WWWWWWWWWWWWWW